Algoritmo:      Conjunto ordenado de instrucciones hacia un ordenador que permite hallar soluciones a problemas
Arreglo:        Tipo de variable que actua en la memoria como hileraContiene la R
Amazon:         Compañia estadounidense de comercio electronico y servicios
Amd:            Famosa marca por fabricacion de procesadores y microprocesadores
Bit:            Unidad base para la computacion que contiene 0 y 1
Byte:           Conjunto basico de bits generalmente usado
Cainf:          Institucion estudiantil que nadie sabe que hace
Camara:         Dispositivo capaz de registrar imagenes estaticas o en movimiento
Datos:          Termino para referirse a la informacion que el usuario introduce y procesa el programa
DLC:            Electronics Arts (EA) famosa compañia de videojuegos por tener que comprar....
Escaner:        Dipositivo que convierte imagenes impresas o documentos a formato digital mediante uso de la luz
Firewall:       Programa que controla el acceso de una computadora a la red por motivos de seguridad
Festival:       Palabra clave de la frase celebre del profesor Asin
Google:         Buscador web mas famoso a nivel mundial
Gigabyte:       Unidad que contiene 1.000.000.000 bytes
Herz:           Unidad de medida para la velocidad a la que trabaja un procesador
Impresora:      Dispositivo que "escriben" informacion de salida en el papel
IP:             "Matricula" que identifica a un ordenador en internet
Instagram:      Plataforma digital mas conocida para compartir fotografias
Java:           Lenguaje de programación orientado a objetos desarrollado por Sun Microsystems
Joystick:       Dispositivo de entrega con forma palanca utilizado para videojuegos
Kilobyte:       Unidad que contiene 1000 bytes
Kernel:         Parte fundamental de un programa, por lo general de un sistema operativo que reside en memoria todo el tiempo y que provee los servicios básicos.
LG:             Una de las mayores empresas eletronicas a nivel mundial caracterizada por sus celulares y televisores
LoL:            Moba mas jugado del mundo
LAN:            Termino para referirse a Red de area local
Malware:        Programas diseñados para causar daños al hardware, software, redes,... como los virus, troyanos, gusanos, nukes
MbpS:           Termino para referirse a megabytes por segundo
Netflix:        Plataforma digital para stremear series o peliculas
Outlook:        Servicio de correos electronicos de propiedad de Microsoft
Play:           Dispositivo de entretenimiento que siempre te pide tu primo cuando llega
Procesador:     Componente de hardware que hace una cantidad de calculos por segundo
Puntero:        Elemento del lenguaje C que te da cancer
QR:             Codigo de barras bidimensional cuadrada que puede almacenar los datos codificados
Quicksort:      Metodo de ordenamiento ampliamente usado en arreglos vectores y matrices
Router:         Componente de hardware que te mandar a reiniciar cada vez que algo falla
Raton:          Componente de hardware que sirve para mover el puntero del sistema operativo
RAM:            Tipo de memoria de computadora rápida, pero de almacenamiento transitorio
Snake:          Videojuego de la primera generacion de celulares con protagonista una serpiente
Silicio:        Elemento fundamental para la fabricacion de microchips
Teclado:        Dispositivo de entrada usado para introducir la informacion de manera escrita
Touch:          Caracteristica de hardware que permite la manipulacion del dispositivo con los dedos
Virus:          Programa informatico que se ejecuta en el ordenador sin previo aviso y que puede corromper el resto de los programas, ficheros de datos e, incluso el mismo sistema operativo
Vidal:          Mejor profesor valorado de la carrera informatica
Xbox:           Consola de videojuego de Microsoft
Xeon:           Submarca de procesadores de Intel
Youtube:        Plataforma digital para subir videos mas conocida
Yandex:         Empresa multinacional de tecnología rusa especializada en servicios y productos relacionados con Internet
Yahoo:          Empresa global dueña de un portal de internet, buscador y protegonista de los memes "Preguntas mas estupidas"
Zilean:         Campeon de videojuego Lol que se caracteriza por lanzar bombas de tiempo
